30
13
aaaaaaaaaaaaaaaaaaaaaaaaaaaaaa
a............................a
a...L........H...............a
a.........................S..a
a............................a
a............................a
a............................a
a............................a
a........................H...a
a............................a
a.....M............I.........a
a............................a
aaaaaaaaaaaaaaaaaaaaaaaaaaaaaa