20
10
aaaaaaaaaaaaaaaaaaaa
a..................a
a...L.......H......a
a..................a
a..................a
a..................a
a...M..........S...a
a.........I........a
a..................a
aaaaaaaaaaaaaaaaaaaa